9 7
4 0 1 0 3 0 2 0 5
0 5 0 2 0 5 0 3 0
2 0 3 0 5 0 1 0 2
0 1 0 4 0 3 0 5 0
3 0 5 0 2 0 5 0 1
0 0 0 0 4 0 0 0 0
0 0 0 0 5 0 0 0 0