9 7
5 2 0 0 0 0 0 1 4
5 0 2 0 3 0 1 0 4
5 0 0 0 5 0 0 0 4
5 0 0 1 0 2 0 0 4
5 0 1 0 3 0 2 0 4
5 1 0 0 0 0 0 2 4