9 8
5 5 5 0 4 0 5 5 5
4 4 0 4 3 4 0 4 4
3 3 0 3 3 3 0 3 3
2 0 5 0 3 0 5 0 2
3 5 2 2 2 2 2 5 3
0 4 1 1 1 1 1 4 0
4 1 0 2 0 2 0 1 4
1 0 0 0 0 0 0 0 1