9 7
0 3 0 1 1 1 0 3 0
2 0 3 0 0 0 3 0 2
0 2 0 5 5 5 0 2 0
0 3 4 1 4 1 4 3 0
0 5 0 0 0 0 0 5 0
0 3 0 0 0 0 0 3 0
0 0 1 1 1 1 1 0 0
