9 8
3 3 3 3 3 3 3 3 3
4 0 4 0 0 0 4 0 4
4 0 4 0 0 0 4 0 4
0 1 0 0 0 0 0 1 0
0 1 0 0 0 0 0 1 0
0 4 5 2 2 2 5 4 0
0 0 5 1 1 1 5 0 0
3 3 3 3 5 3 3 3 3