9 7
1 1 1 0 0 0 1 1 1
0 0 0 5 5 5 0 0 0
0 0 5 0 0 0 5 0 0
0 0 4 0 0 0 4 0 0
2 2 3 5 5 5 3 2 2
0 0 0 0 0 0 0 0 0
0 0 0 5 4 5 0 0 0